tileset.png
10
10
16
16
10
0,0,0,0,0,0,0,0,0,0,
0,604,604,604,604,604,604,604,604,0,
0,604,604,604,604,604,604,604,604,0,
0,3,3,3,3,3,3,3,3,0,
0,3,3,3,3,3,3,3,3,0,
0,3,3,3,3,3,3,3,3,0,
0,3,3,3,3,3,3,3,3,0,
0,3,3,3,3,3,3,3,3,0,
0,3,3,3,3,3,3,3,3,0,
0,0,0,0,0,0,0,0,0,0
0,0,0,0,0,0,0,0,0,0,
0,0,0,0,0,0,0,0,0,0,
0,0,0,0,0,0,0,0,0,0,
0,0,322,0,86,138,67,68,0,0,
0,0,372,0,0,0,0,0,0,0,
0,0,0,0,0,0,0,0,0,0,
0,0,0,0,0,0,0,0,0,0,
0,0,0,0,0,0,0,0,0,0,
0,0,0,0,0,0,0,0,0,0,
0,0,0,0,0,0,0,0,0,0
2500,2500,2500,2500,2500,2500,2500,2500,2500,2500,
2500,0,0,0,0,0,0,0,0,2500,
2500,0,0,0,0,0,0,0,0,2500,
2500,0,0,0,0,0,0,0,0,2500,
2500,0,0,0,0,0,0,0,0,2500,
2500,0,0,0,0,0,0,0,0,2500,
2500,0,0,0,0,0,0,0,0,2500,
2500,0,0,686,0,0,0,0,0,2500,
2500,0,0,0,0,0,0,721,0,2500,
2500,2500,2500,2500,2500,2500,2500,2500,2500,2500
