tileset.png
8
8
16
16
10
0 0 0 0 0 0 0 0 
0 0 0 0 0 0 0 0 
0 3 3 3 3 3 3 0 
0 3 3 3 3 3 3 0 
0 3 3 3 3 3 3 0 
0 3 3 3 3 3 3 0 
0 3 3 3 3 3 3 0 
0 3 3 3 3 3 3 0
709 657 657 657 657 657 657 709 
709 657 657 657 657 657 657 709 
709 321 0 0 67 68 72 709 
709 371 0 0 0 0 0 709 
709 0 0 0 0 0 0 709 
709 0 0 0 0 0 0 709 
709 0 0 0 0 0 0 709 
709 0 0 0 0 0 0 709
0 0 0 49 0 0 0 0 
0 0 0 0 0 0 0 0 
0 0 0 86 0 0 0 0 
0 0 0 0 0 0 0 0 
0 0 0 667 668 0 0 0 
0 0 0 717 718 0 0 0 
0 0 0 0 0 0 0 0 
0 0 0 0 0 721 0 0
