tileset.png
8
8
16
16
10
604,604,604,604,604,604,604,604,
604,604,604,604,604,604,604,604,
3,3,3,3,3,3,3,3,
3,3,3,3,3,3,3,3,
3,3,3,3,3,3,3,3,
3,3,3,3,3,3,3,3,
3,3,3,3,3,3,3,3,
3,3,3,3,3,3,3,3
0,0,0,49,0,0,0,0,
0,0,0,0,0,0,0,0,
322,0,0,86,138,67,68,72,
372,0,0,0,0,0,0,0,
0,0,0,0,0,0,0,0,
0,0,0,0,0,0,0,0,
0,0,0,0,0,0,0,0,
0,0,0,0,0,0,721,0
0,0,0,0,0,0,0,0,
0,0,0,0,0,0,0,0,
0,0,0,0,0,0,0,0,
0,0,0,0,0,0,0,0,
0,0,0,0,0,0,0,0,
0,0,0,0,0,0,0,0,
0,0,0,0,0,0,0,0,
0,0,0,0,0,0,0,0
